genre,Nintendo,Electronic_Arts,Sony_Computer_Entertainment,Ubisoft,Capcom,Total
Action,79,183,90,193,154,699
Adventure,35,13,41,59,22,170
Fighting,18,39,30,19,58,164
Misc,100,46,128,151,11,436
Platform,112,16,66,70,46,310
Puzzle,74,7,12,24,6,123
Racing,37,159,65,52,13,326
Role-Playing,106,35,49,41,38,269
Shooter,26,139,51,92,25,333
Simulation,29,116,15,119,2,281
Sports,55,561,124,72,3,815
Strategy,32,37,12,29,3,113
